@MapData  80, 25, 48, 48, ../image/mapchip3.png
@Back
-1, -1, -1, -1, -1, -1, -1, -1, -1, -1, -1, -1, -1, -1, -1, -1, -1, -1, -1, -1, -1, -1, -1, -1, -1, -1, -1, -1, -1, -1, -1, -1, -1, -1, -1, -1, -1, -1, -1, -1, -1, -1, -1, -1, -1, -1, -1, -1, -1, -1, -1, -1, -1, -1, -1, -1, -1, -1, -1, -1, -1, -1, -1, -1, -1, -1, -1, -1, -1, -1, -1, -1, -1, -1, -1, -1, -1, -1, -1, -1, 
-1, -1, -1, -1, -1, -1, -1, -1, -1, -1, -1, -1, -1, -1, -1, -1, -1, -1, -1, -1, -1, -1, -1, -1, -1, -1, -1, -1, -1, -1, -1, -1, -1, -1, -1, -1, -1, -1, -1, -1, -1, -1, -1, -1, -1, -1, -1, -1, -1, -1, -1, -1, -1, -1, -1, -1, -1, -1, -1, -1, -1, -1, -1, -1, -1, -1, -1, -1, -1, -1, -1, -1, -1, -1, -1, -1, -1, -1, -1, -1, 
-1, -1, -1, -1, -1, -1, -1, -1, -1, -1, -1, -1, -1, -1, -1, -1, -1, -1, -1, -1, -1, -1, -1, -1, -1, -1, -1, -1, -1, -1, -1, -1, -1, -1, -1, -1, -1, -1, -1, -1, -1, -1, -1, -1, -1, -1, -1, -1, -1, -1, -1, -1, -1, -1, -1, -1, -1, -1, -1, -1, -1, -1, -1, -1, -1, -1, -1, -1, -1, -1, -1, -1, -1, -1, -1, -1, -1, -1, -1, -1, 
-1, -1, -1, -1, -1, -1, -1, -1, -1, -1, -1, -1, -1, -1, -1, -1, -1, -1, -1, -1, -1, -1, -1, -1, -1, -1, -1, -1, -1, -1, -1, -1, -1, -1, -1, -1, -1, -1, -1, -1, -1, -1, -1, -1, -1, -1, -1, -1, -1, -1, -1, -1, -1, -1, -1, -1, -1, -1, -1, -1, -1, -1, -1, -1, -1, -1, -1, -1, -1, -1, -1, -1, -1, -1, -1, -1, -1, -1, -1, -1, 
-1, -1, -1, -1, -1, -1, -1, -1, -1, -1, -1, -1, -1, -1, -1, -1, -1, -1, -1, -1, -1, -1, -1, -1, -1, -1, -1, -1, -1, -1, -1, -1, -1, -1, -1, -1, -1, -1, -1, -1, -1, -1, -1, -1, -1, -1, -1, -1, -1, -1, -1, -1, -1, -1, -1, -1, -1, -1, -1, -1, -1, -1, -1, -1, -1, -1, -1, -1, -1, -1, -1, -1, -1, -1, -1, -1, -1, -1, -1, -1, 
-1, -1, -1, -1, -1, -1, -1, -1, -1, -1, -1, -1, -1, -1, -1, -1, -1, -1, -1, -1, -1, -1, -1, -1, -1, -1, -1, -1, -1, -1, -1, -1, -1, -1, -1, -1, -1, -1, -1, -1, -1, -1, -1, -1, -1, -1, -1, -1, -1, -1, -1, -1, -1, -1, -1, -1, -1, -1, -1, -1, -1, -1, -1, -1, -1, -1, -1, -1, -1, -1, -1, -1, -1, -1, -1, -1, -1, -1, -1, -1, 
-1, -1, -1, -1, -1, -1, -1, -1, -1, -1, -1, -1, -1, -1, -1, -1, -1, -1, -1, -1, -1, -1, -1, -1, -1, -1, -1, -1, -1, -1, -1, -1, -1, -1, -1, -1, -1, -1, -1, -1, -1, -1, -1, -1, -1, -1, -1, -1, -1, -1, -1, -1, -1, -1, -1, -1, -1, -1, -1, -1, -1, -1, -1, -1, -1, -1, -1, -1, -1, -1, -1, -1, -1, -1, -1, -1, -1, -1, -1, -1, 
-1, -1, -1, -1, -1, -1, -1, -1, -1, -1, -1, -1, -1, -1, -1, -1, -1, -1, 2008, 2006, 2006, 2006, 2006, 2006, 2006, 2006, 2006, 2006, 2006, 2006, 2006, 2006, 2006, 2006, 2006, 2006, 2006, 2006, 2006, 2006, 2006, 2006, 2006, 2006, 2006, 2006, 2006, 2006, 2006, 2006, 2006, 2006, 2006, 2006, 2006, 2006, 2006, 2006, 2006, 2006, 2009, -1, -1, -1, -1, -1, -1, -1, -1, -1, -1, -1, -1, -1, -1, -1, -1, -1, -1, -1, 
-1, -1, -1, -1, -1, -1, -1, -1, -1, -1, -1, -1, -1, -1, -1, -1, -1, -1, 3012, 3011, 3011, 3011, 3011, 3011, 3011, 3011, 3011, 3011, 3011, 3011, 3011, 3011, 3011, 3011, 2011, 3011, 3011, 2011, 3011, 3011, 2011, 3011, 3011, 2011, 3011, 3011, 2011, 3011, 3011, 2011, 3011, 3011, 2011, 3011, 3011, 2011, 3011, 3011, 2011, 3011, 3013, -1, -1, -1, -1, -1, -1, -1, -1, -1, -1, -1, -1, -1, -1, -1, -1, -1, -1, -1, 
-1, -1, -1, -1, -1, -1, -1, -1, -1, -1, -1, -1, -1, -1, -1, -1, -1, -1, 3012, 3011, 3011, 3011, 2011, 3011, 3011, 3011, 3011, 2011, 3011, 3011, 3011, 3011, 3011, 3011, 3011, 3011, 3011, 3011, 3011, 3011, 3011, 3011, 3011, 3011, 3011, 3011, 3011, 3011, 3011, 3011, 3011, 3011, 3011, 3011, 3011, 3011, 3011, 3011, 3011, 3011, 3013, -1, -1, -1, -1, -1, -1, -1, -1, -1, -1, -1, -1, -1, -1, -1, -1, -1, -1, -1, 
-1, -1, -1, -1, -1, -1, -1, -1, -1, -1, -1, -1, -1, -1, -1, -1, -1, -1, 3012, 3011, 3011, 3011, 3011, 3011, 3011, 3011, 3011, 3011, 3011, 3011, 3011, 3011, 3011, 2002, 2001, 2001, 3011, 3011, 3011, 3011, 3011, 3011, 3011, 3011, 3011, 3011, 3011, 3011, 3011, 3011, 3011, 3011, 3011, 3011, 3011, 3011, 3011, 3011, 3011, 3011, 3013, -1, -1, -1, -1, -1, -1, -1, -1, -1, -1, -1, -1, -1, -1, -1, -1, -1, -1, -1, 
-1, -1, -1, -1, -1, -1, -1, -1, -1, -1, -1, -1, -1, -1, -1, -1, -1, -1, 3012, 3011, 3011, 3011, 2011, 3011, 3011, 3011, 3011, 2011, 3011, 3011, 3011, 3011, 3011, 3001, 3001, 3001, 3001, 3011, 3011, 3011, 2011, 3011, 3011, 2011, 3011, 3011, 2011, 3011, 3011, 2011, 3011, 3011, 2011, 3011, 3011, 2011, 3011, 3011, 3011, 3011, 3013, -1, -1, -1, -1, -1, -1, -1, -1, -1, -1, -1, -1, -1, -1, -1, -1, -1, -1, -1, 
-1, -1, -1, -1, -1, -1, -1, -1, -1, -1, -1, -1, -1, -1, -1, -1, -1, -1, 3012, 3011, 3011, 3011, 3011, 3011, 3011, 3011, 3011, 3011, 3011, 3011, 3011, 3011, 3011, 3002, 3001, 3001, 3001, 3001, 3011, 3011, 3011, 3011, 3011, 3011, 3011, 3011, 3011, 3011, 3011, 3011, 3011, 3011, 3011, 3011, 3011, 3011, 3011, 3011, 4008, 4010, 4009, -1, -1, -1, -1, -1, -1, -1, -1, -1, -1, -1, -1, -1, -1, -1, -1, -1, -1, -1, 
-1, -1, -1, -1, -1, -1, -1, -1, -1, -1, -1, -1, -1, -1, -1, -1, -1, -1, 3012, 3011, 3011, 3011, 2011, 3011, 3011, 3011, 3011, 2011, 3011, 3011, 3011, 3011, 3011, 3002, 3001, 3001, 3001, 3001, 3001, 3011, 3011, 3011, 3011, 3011, 3011, 3011, 3011, 3011, 3011, 3011, 3011, 3011, 3011, 3011, 3011, 3011, 3011, 3011, 5008, 5010, 5009, -1, -1, -1, -1, -1, -1, -1, -1, -1, -1, -1, -1, -1, -1, -1, -1, -1, -1, -1, 
-1, -1, -1, -1, -1, -1, -1, -1, -1, -1, -1, -1, -1, -1, -1, -1, -1, -1, 3012, 3011, 3011, 3011, 3011, 3011, 3011, 3011, 3011, 3011, 3011, 3011, 3011, 3011, 3011, 3002, 3001, 3001, 3001, 3001, 3001, 3001, 2001, 2001, 2003, 3011, 3011, 3011, 2002, 3003, 3011, 3011, 2002, 2003, 3011, 3011, 3011, 2002, 2001, 2001, 2001, 2001, 2003, -1, -1, -1, -1, -1, -1, -1, -1, -1, -1, -1, -1, -1, -1, -1, -1, -1, -1, -1, 
-1, -1, -1, -1, -1, -1, -1, -1, -1, -1, -1, -1, -1, -1, -1, -1, -1, -1, 3012, 3011, 3011, 3011, 2011, 3011, 3011, 3011, 3011, 2011, 3011, 3011, 3011, 3011, 3011, 3002, 3001, 3001, 3001, 3001, 3001, 3001, 3001, 3001, 3003, 3011, 3011, 3011, 3002, 3003, 3011, 3011, 3002, 3003, 3011, 3011, 3011, 3002, 3001, 3001, 3001, 3001, 3003, -1, -1, -1, -1, -1, -1, -1, -1, -1, -1, -1, -1, -1, -1, -1, -1, -1, -1, -1, 
2006, 2006, 2006, 2006, 2006, 2006, 2006, 2006, 2006, 2006, 2006, 2006, 2006, 2006, 2006, 2006, 2006, 2006, 3011, 3011, 3011, 3011, 3011, 3011, 3011, 3011, 3011, 3011, 3011, 3011, 3011, 3011, 3011, 3002, 3001, 3001, 3001, 3001, 3001, 3001, 3001, 3001, 3003, 3011, 3011, 3011, 3002, 3003, 3011, 3011, 3002, 3003, 3011, 3011, 3011, 3002, 3001, 3001, 3001, 3001, 3003, -1, -1, -1, -1, -1, -1, -1, -1, -1, -1, -1, -1, -1, -1, -1, -1, -1, -1, -1, 
3011, 2011, 3011, 3011, 2011, 3011, 3011, 2011, 3011, 3011, 2011, 3011, 3011, 2011, 3011, 3011, 2011, 3011, 3011, 3011, 3011, 3011, 2011, 3011, 3011, 3011, 3011, 2011, 3011, 3011, 3011, 3011, 3011, 3002, 3001, 3001, 3001, 3001, 3001, 3001, 3001, 3001, 3003, 3011, 3011, 3011, 3002, 3003, 3011, 3011, 3002, 3003, 3011, 3011, 3011, 3002, 3001, 3001, 3001, 3001, 3003, -1, -1, -1, -1, -1, -1, -1, -1, -1, -1, -1, -1, -1, -1, -1, -1, -1, -1, -1, 
3006, 3006, 3006, 3006, 3006, 3011, 3011, 3011, 3011, 3011, 3011, 3011, 3011, 3011, 3011, 3011, 3011, 3011, 3011, 3011, 3011, 3011, 3011, 3011, 3011, 3011, 3011, 3011, 3011, 3011, 3011, 3011, 3011, 3002, 3001, 3001, 3001, 3001, 3001, 3001, 3001, 3001, 3003, 3011, 3011, 3011, 3002, 3003, 3011, 3011, 3002, 3003, 3011, 3011, 3011, 3002, 3001, 3001, 3001, 3001, 3003, -1, -1, -1, -1, -1, -1, -1, -1, -1, -1, -1, -1, -1, -1, -1, -1, -1, -1, -1, 
3001, 3001, 3001, 3001, 3001, 3011, 3011, 3011, 3011, 3011, 3011, 3011, 3011, 3011, 3011, 3011, 3011, 3011, 3011, 3011, 3011, 3011, 2011, 3011, 3011, 3011, 3011, 2011, 3011, 3011, 3011, 3011, 3011, 3002, 3001, 3001, 3001, 3001, 3001, 3001, 3001, 3001, 3001, 2001, 2001, 2001, 3001, 3001, 2001, 2001, 3001, 3001, 2001, 2001, 2001, 3001, 3001, 3001, 3001, 3001, 3003, -1, -1, -1, -1, -1, -1, -1, -1, -1, -1, -1, -1, -1, -1, -1, -1, -1, -1, -1, 
3001, 3001, 3001, 3001, 3001, 3001, 3011, 3006, 3006, 3006, 3011, 3011, 3011, 3006, 3006, 3011, 3011, 3011, 3006, 3006, 3006, 3011, 3011, 3011, 2002, 3001, 3003, 3011, 3011, 3011, 3011, 3011, 3011, 3002, 3001, 3001, 3001, 3001, 3001, 3001, 3001, 3001, 3001, 3001, 3001, 3001, 3001, 3001, 3001, 3001, 3001, 3001, 3001, 3001, 3001, 3001, 3001, 3001, 3001, 3001, 3003, -1, -1, -1, -1, -1, -1, -1, -1, -1, -1, -1, -1, -1, -1, -1, -1, -1, -1, -1, 
3001, 3001, 3001, 3001, 3001, 3001, 3001, 2001, 2001, 2003, 3011, 3011, 3011, 2002, 2003, 3011, 3011, 3011, 2002, 2001, 2003, 3011, 3011, 3011, 3002, 3001, 3003, 3011, 3011, 3011, 3011, 3011, 3011, 3002, 3001, 3001, 3001, 3001, 3001, 3001, 3001, 3001, 3001, 3001, 3001, 3001, 3001, 3001, 3001, 3001, 3001, 3001, 3001, 3001, 3001, 3001, 3001, 3001, 3001, 3001, 3003, -1, -1, -1, -1, -1, -1, -1, -1, -1, -1, -1, -1, -1, -1, -1, -1, -1, -1, -1, 
3001, 3001, 3001, 3001, 3001, 3001, 3001, 3001, 3001, 3003, 3011, 3011, 3011, 3002, 3003, 3011, 3011, 3011, 3002, 3001, 3003, 3011, 3011, 3011, 3002, 3001, 3003, 3011, 3011, 3011, 3011, 3011, 3011, 3002, 3001, 3001, 3001, 3001, 3001, 3001, 3001, 3001, 3001, 3001, 3001, 3001, 3001, 3001, 3001, 3001, 3001, 3001, 3001, 3001, 3001, 3001, 3001, 3001, 3001, 3001, 3003, -1, -1, -1, -1, -1, -1, -1, -1, -1, -1, -1, -1, -1, -1, -1, -1, -1, -1, -1, 
3001, 3001, 3001, 3001, 3001, 3001, 3001, 3001, 3001, 3003, 3011, 3011, 3011, 3002, 3003, 3011, 3011, 3011, 3002, 3001, 3003, 3011, 3011, 3011, 3002, 3001, 3003, 3011, 3011, 3011, 3011, 3011, 3011, 3002, 3001, 3001, 3001, 3001, 3001, 3001, 3001, 3001, 3001, 3001, 3001, 3001, 3001, 3001, 3001, 3001, 3001, 3001, 3001, 3001, 3001, 3001, 3001, 3001, 3001, 3001, 3003, -1, -1, -1, -1, -1, -1, -1, -1, -1, -1, -1, -1, -1, -1, -1, -1, -1, -1, -1, 
3001, 3001, 3001, 3001, 3001, 3001, 3001, 3001, 3001, 3003, 3006, 3006, 3006, 3002, 3003, 3006, 3006, 3006, 3002, 3001, 3003, 3006, 3006, 3006, 3002, 3001, 3003, 3006, 3006, 3006, 3006, 3006, 3006, 3002, 3001, 3001, 3001, 3001, 3001, 3001, 3001, 3001, 3001, 3001, 3001, 3001, 3001, 3001, 3001, 3001, 3001, 3001, 3001, 3001, 3001, 3001, 3001, 3001, 3001, 3001, 3003, -1, -1, -1, -1, -1, -1, -1, -1, -1, -1, -1, -1, -1, -1, -1, -1, -1, -1, -1, 
@Fore
-1, -1, -1, -1, -1, -1, -1, -1, -1, -1, -1, -1, -1, -1, -1, -1, -1, -1, -1, -1, -1, -1, -1, -1, -1, -1, -1, -1, -1, -1, -1, -1, -1, -1, -1, -1, -1, -1, -1, -1, -1, -1, -1, -1, -1, -1, -1, -1, -1, -1, -1, -1, -1, -1, -1, -1, -1, -1, -1, -1, -1, -1, -1, -1, -1, -1, -1, -1, -1, -1, -1, -1, -1, -1, -1, -1, -1, -1, -1, -1, 
-1, -1, -1, -1, -1, -1, -1, -1, -1, -1, -1, -1, -1, -1, -1, -1, -1, -1, -1, -1, -1, -1, -1, -1, -1, -1, -1, -1, -1, -1, -1, -1, -1, -1, -1, -1, -1, -1, -1, -1, -1, -1, -1, -1, -1, -1, -1, -1, -1, -1, -1, -1, -1, -1, -1, -1, -1, -1, -1, -1, -1, -1, -1, -1, -1, -1, -1, -1, -1, -1, -1, -1, -1, -1, -1, -1, -1, -1, -1, -1, 
-1, -1, -1, -1, -1, -1, -1, -1, -1, -1, -1, -1, -1, -1, -1, -1, -1, -1, -1, -1, -1, -1, -1, -1, -1, -1, -1, -1, -1, -1, -1, -1, -1, -1, -1, -1, -1, -1, -1, -1, -1, -1, -1, -1, -1, -1, -1, -1, -1, -1, -1, -1, -1, -1, -1, -1, -1, -1, -1, -1, -1, -1, -1, -1, -1, -1, -1, -1, -1, -1, -1, -1, -1, -1, -1, -1, -1, -1, -1, -1, 
-1, -1, -1, -1, -1, -1, -1, -1, -1, -1, -1, -1, -1, -1, -1, -1, -1, -1, -1, -1, -1, -1, -1, -1, -1, -1, -1, -1, -1, -1, -1, -1, -1, -1, -1, -1, -1, -1, -1, -1, -1, -1, -1, -1, -1, -1, -1, -1, -1, -1, -1, -1, -1, -1, -1, -1, -1, -1, -1, -1, -1, -1, -1, -1, -1, -1, -1, -1, -1, -1, -1, -1, -1, -1, -1, -1, -1, -1, -1, -1, 
-1, -1, -1, -1, -1, -1, -1, -1, -1, -1, -1, -1, -1, -1, -1, -1, -1, -1, -1, -1, -1, -1, -1, -1, -1, -1, -1, -1, -1, -1, -1, -1, -1, -1, -1, -1, -1, -1, -1, -1, -1, -1, -1, -1, -1, -1, -1, -1, -1, -1, -1, -1, -1, -1, -1, -1, -1, -1, -1, -1, -1, -1, -1, -1, -1, -1, -1, -1, -1, -1, -1, -1, -1, -1, -1, -1, -1, -1, -1, -1, 
-1, -1, -1, -1, -1, -1, -1, -1, -1, -1, -1, -1, -1, -1, -1, -1, -1, -1, -1, -1, -1, -1, -1, -1, -1, -1, -1, -1, -1, -1, -1, -1, -1, -1, -1, -1, -1, -1, -1, -1, -1, -1, -1, -1, -1, -1, -1, -1, -1, -1, -1, -1, -1, -1, -1, -1, -1, -1, -1, -1, -1, -1, -1, -1, -1, -1, -1, -1, -1, -1, -1, -1, -1, -1, -1, -1, -1, -1, -1, -1, 
-1, -1, -1, -1, -1, -1, -1, -1, -1, -1, -1, -1, -1, -1, -1, -1, -1, -1, -1, -1, -1, -1, -1, -1, -1, -1, -1, -1, -1, -1, -1, -1, -1, -1, -1, -1, -1, -1, -1, -1, -1, -1, -1, -1, -1, -1, -1, -1, -1, -1, -1, -1, -1, -1, -1, -1, -1, -1, -1, -1, -1, -1, -1, -1, -1, -1, -1, -1, -1, -1, -1, -1, -1, -1, -1, -1, -1, -1, -1, -1, 
-1, -1, -1, -1, -1, -1, -1, -1, -1, -1, -1, -1, -1, -1, -1, -1, -1, -1, -1, -1, -1, -1, -1, -1, -1, -1, -1, -1, -1, -1, -1, -1, -1, -1, -1, -1, -1, -1, -1, -1, -1, -1, -1, -1, -1, -1, -1, -1, -1, -1, -1, -1, -1, -1, -1, -1, -1, -1, -1, -1, -1, -1, -1, -1, -1, -1, -1, -1, -1, -1, -1, -1, -1, -1, -1, -1, -1, -1, -1, -1, 
-1, -1, -1, -1, -1, -1, -1, -1, -1, -1, -1, -1, -1, -1, -1, -1, -1, -1, -1, -1, -1, -1, -1, -1, -1, -1, -1, -1, -1, -1, -1, -1, -1, -1, -1, -1, -1, -1, -1, -1, -1, -1, -1, -1, -1, -1, -1, -1, -1, -1, -1, -1, -1, -1, -1, -1, -1, -1, -1, -1, -1, -1, -1, -1, -1, -1, -1, -1, -1, -1, -1, -1, -1, -1, -1, -1, -1, -1, -1, -1, 
-1, -1, -1, -1, -1, -1, -1, -1, -1, -1, -1, -1, -1, -1, -1, -1, -1, -1, -1, -1, -1, -1, -1, -1, -1, -1, -1, -1, -1, -1, -1, -1, -1, -1, -1, -1, -1, -1, -1, -1, -1, -1, -1, -1, -1, -1, -1, -1, -1, -1, -1, -1, -1, -1, -1, -1, -1, -1, -1, -1, -1, -1, -1, -1, -1, -1, -1, -1, -1, -1, -1, -1, -1, -1, -1, -1, -1, -1, -1, -1, 
-1, -1, -1, -1, -1, -1, -1, -1, -1, -1, -1, -1, -1, -1, -1, -1, -1, -1, -1, -1, -1, -1, -1, -1, -1, -1, -1, -1, -1, 3004, 2004, -1, -1, -1, -1, -1, 5000, -1, -1, -1, -1, -1, -1, -1, -1, -1, -1, -1, -1, -1, -1, -1, -1, -1, -1, -1, -1, -1, -1, -1, -1, -1, -1, -1, -1, -1, -1, -1, -1, -1, -1, -1, -1, -1, -1, -1, -1, -1, -1, -1, 
-1, -1, -1, -1, -1, -1, -1, -1, -1, -1, -1, -1, -1, -1, -1, -1, -1, -1, -1, -1, -1, -1, -1, -1, 3004, 2004, -1, -1, -1, -1, -1, -1, -1, -1, -1, -1, -1, 5000, -1, -1, -1, -1, -1, -1, -1, -1, -1, -1, -1, -1, -1, -1, -1, -1, -1, -1, -1, -1, -1, -1, -1, -1, -1, -1, -1, -1, -1, -1, -1, -1, -1, -1, -1, -1, -1, -1, -1, -1, -1, -1, 
-1, -1, -1, -1, -1, -1, -1, -1, -1, -1, -1, -1, -1, -1, -1, -1, -1, -1, -1, 3004, 2004, -1, -1, -1, -1, -1, -1, -1, -1, -1, -1, -1, -1, -1, -1, -1, -1, -1, 5000, -1, -1, -1, -1, -1, -1, -1, -1, -1, -1, -1, -1, -1, -1, -1, -1, -1, -1, -1, -1, -1, -1, -1, -1, -1, -1, -1, -1, -1, -1, -1, -1, -1, -1, -1, -1, -1, -1, -1, -1, -1, 
-1, -1, -1, -1, -1, -1, -1, -1, -1, -1, -1, -1, -1, -1, -1, -1, -1, -1, -1, -1, -1, -1, -1, -1, 3004, 2004, -1, -1, -1, -1, -1, -1, -1, -1, -1, -1, -1, -1, -1, 5000, -1, -1, -1, -1, -1, -1, -1, -1, -1, -1, -1, -1, -1, -1, -1, -1, -1, -1, -1, -1, -1, -1, -1, -1, -1, -1, -1, -1, -1, -1, -1, -1, -1, -1, -1, -1, -1, -1, -1, -1, 
-1, -1, -1, -1, -1, -1, -1, -1, -1, -1, -1, -1, -1, -1, -1, -1, -1, -1, -1, -1, -1, -1, -1, -1, -1, -1, -1, -1, -1, 3004, 2004, -1, -1, -1, -1, -1, -1, -1, -1, -1, -1, -1, -1, -1, -1, -1, -1, -1, -1, -1, -1, -1, -1, -1, -1, -1, -1, -1, -1, -1, -1, -1, -1, -1, -1, -1, -1, -1, -1, -1, -1, -1, -1, -1, -1, -1, -1, -1, -1, -1, 
-1, -1, -1, -1, -1, -1, -1, -1, -1, -1, -1, -1, -1, -1, -1, -1, -1, -1, -1, -1, -1, -1, -1, -1, 3004, 2004, -1, -1, -1, -1, -1, -1, -1, -1, -1, -1, -1, -1, -1, -1, -1, -1, -1, -1, -1, -1, -1, -1, -1, -1, -1, -1, -1, -1, -1, -1, -1, -1, -1, -1, -1, -1, -1, -1, -1, -1, -1, -1, -1, -1, -1, -1, -1, -1, -1, -1, -1, -1, -1, -1, 
-1, -1, -1, -1, -1, -1, -1, -1, -1, -1, -1, -1, -1, -1, -1, -1, -1, -1, -1, 3004, 2004, -1, -1, -1, -1, -1, -1, -1, -1, -1, -1, -1, -1, -1, -1, -1, -1, -1, -1, -1, -1, -1, -1, -1, -1, -1, -1, -1, -1, -1, -1, -1, -1, -1, -1, -1, -1, -1, -1, -1, -1, -1, -1, -1, -1, -1, -1, -1, -1, -1, -1, -1, -1, -1, -1, -1, -1, -1, -1, -1, 
-1, -1, -1, -1, -1, -1, -1, -1, -1, -1, -1, -1, -1, -1, -1, -1, -1, -1, -1, -1, -1, -1, -1, -1, 3004, 2004, -1, -1, -1, -1, -1, -1, -1, -1, -1, -1, -1, -1, -1, -1, -1, -1, -1, -1, -1, -1, -1, -1, -1, -1, -1, -1, -1, -1, -1, -1, -1, -1, -1, -1, -1, -1, -1, -1, -1, -1, -1, -1, -1, -1, -1, -1, -1, -1, -1, -1, -1, -1, -1, -1, 
-1, -1, -1, -1, -1, -1, -1, -1, -1, -1, -1, -1, -1, -1, -1, -1, -1, -1, -1, -1, -1, -1, -1, -1, -1, -1, -1, -1, -1, 3004, 2004, -1, -1, -1, -1, -1, -1, -1, -1, -1, -1, -1, -1, -1, -1, -1, -1, -1, -1, -1, -1, -1, -1, -1, -1, -1, -1, -1, -1, -1, -1, -1, -1, -1, -1, -1, -1, -1, -1, -1, -1, -1, -1, -1, -1, -1, -1, -1, -1, -1, 
-1, -1, -1, -1, -1, 5000, -1, -1, -1, -1, -1, -1, -1, -1, -1, -1, -1, -1, -1, -1, -1, -1, -1, -1, -1, -1, -1, -1, -1, -1, -1, -1, -1, -1, -1, -1, -1, -1, -1, -1, -1, -1, -1, -1, -1, -1, -1, -1, -1, -1, -1, -1, -1, -1, -1, -1, -1, -1, -1, -1, -1, -1, -1, -1, -1, -1, -1, -1, -1, -1, -1, -1, -1, -1, -1, -1, -1, -1, -1, -1, 
-1, -1, -1, -1, -1, -1, 5000, -1, -1, -1, -1, -1, -1, -1, -1, -1, -1, -1, -1, -1, -1, -1, -1, -1, -1, -1, -1, -1, -1, -1, -1, -1, -1, -1, -1, -1, -1, -1, -1, -1, -1, -1, -1, -1, -1, -1, -1, -1, -1, -1, -1, -1, -1, -1, -1, -1, -1, -1, -1, -1, -1, -1, -1, -1, -1, -1, -1, -1, -1, -1, -1, -1, -1, -1, -1, -1, -1, -1, -1, -1, 
-1, -1, -1, -1, -1, -1, -1, -1, -1, -1, -1, -1, -1, -1, -1, -1, -1, -1, -1, -1, -1, -1, -1, -1, -1, -1, -1, -1, -1, -1, -1, -1, -1, -1, -1, -1, -1, -1, -1, -1, -1, -1, -1, -1, -1, -1, -1, -1, -1, -1, -1, -1, -1, -1, -1, -1, -1, -1, -1, -1, -1, -1, -1, -1, -1, -1, -1, -1, -1, -1, -1, -1, -1, -1, -1, -1, -1, -1, -1, -1, 
-1, -1, -1, -1, -1, -1, -1, -1, -1, -1, -1, -1, -1, -1, -1, -1, -1, -1, -1, -1, -1, -1, -1, -1, -1, -1, -1, -1, -1, -1, -1, -1, -1, -1, -1, -1, -1, -1, -1, -1, -1, -1, -1, -1, -1, -1, -1, -1, -1, -1, -1, -1, -1, -1, -1, -1, -1, -1, -1, -1, -1, -1, -1, -1, -1, -1, -1, -1, -1, -1, -1, -1, -1, -1, -1, -1, -1, -1, -1, -1, 
-1, -1, -1, -1, -1, -1, -1, -1, -1, -1, -1, -1, -1, -1, -1, -1, -1, -1, -1, -1, -1, -1, -1, -1, -1, -1, -1, -1, -1, -1, -1, -1, -1, -1, -1, -1, -1, -1, -1, -1, -1, -1, -1, -1, -1, -1, -1, -1, -1, -1, -1, -1, -1, -1, -1, -1, -1, -1, -1, -1, -1, -1, -1, -1, -1, -1, -1, -1, -1, -1, -1, -1, -1, -1, -1, -1, -1, -1, -1, -1, 
-1, -1, -1, -1, -1, -1, -1, -1, -1, -1, -1, -1, -1, -1, -1, -1, -1, -1, -1, -1, -1, -1, -1, -1, -1, -1, -1, -1, -1, -1, -1, -1, -1, -1, -1, -1, -1, -1, -1, -1, -1, -1, -1, -1, -1, -1, -1, -1, -1, -1, -1, -1, -1, -1, -1, -1, -1, -1, -1, -1, -1, -1, -1, -1, -1, -1, -1, -1, -1, -1, -1, -1, -1, -1, -1, -1, -1, -1, -1, -1, 
@MapLine  72
    0,    0,        0,  912,    1.00000,-0.00000
    0,  912,      240,  912,    0.00000,-1.00000
  240,  912,      336, 1008,    0.70711,-0.70711
  336, 1008,      480, 1008,    0.00000,-1.00000
  480, 1008,      480, 1200,    1.00000,-0.00000
  480, 1200,      624, 1200,    0.00000,-1.00000
  624, 1200,      624, 1008,    -1.00000,-0.00000
  624, 1008,      720, 1008,    0.00000,-1.00000
  720, 1008,      720, 1200,    1.00000,-0.00000
  720, 1200,      864, 1200,    0.00000,-1.00000
  864, 1200,      864, 1008,    -1.00000,-0.00000
  864, 1008,     1008, 1008,    0.00000,-1.00000
 1008, 1008,     1008, 1200,    1.00000,-0.00000
 1008, 1200,     1152, 1200,    0.00000,-1.00000
 1152, 1200,     1152,  960,    -1.00000,-0.00000
 1152,  960,     1296,  960,    0.00000,-1.00000
 1296,  960,     1296, 1200,    1.00000,-0.00000
 1296, 1200,     1600, 1200,    0.00000,-1.00000
 1600, 1200,     1584,  480,    -0.99975,0.02222
 1584,  480,     1728,  480,    0.00000,-1.00000
 1728,  480,     1920,  672,    0.70711,-0.70711
 1920,  672,     2064,  672,    0.00000,-1.00000
 2064,  672,     2064,  912,    1.00000,-0.00000
 2064,  912,     2208,  912,    0.00000,-1.00000
 2208,  912,     2208,  672,    -1.00000,-0.00000
 2208,  672,     2304,  672,    0.00000,-1.00000
 2304,  672,     2304,  912,    1.00000,-0.00000
 2304,  912,     2400,  912,    0.00000,-1.00000
 2400,  912,     2400,  672,    -1.00000,-0.00000
 2400,  672,     2496,  672,    0.00000,-1.00000
 2496,  672,     2496,  912,    1.00000,-0.00000
 2496,  912,     2640,  912,    0.00000,-1.00000
 2640,  912,     2640,  672,    -1.00000,-0.00000
 2640,  672,     2928,  672,    0.00000,-1.00000
 2928,  672,     2880,    0,    -0.99746,0.07125
 2880,    0,        0,    0,    0.00000,1.00000
  912,  768,     1008,  768,    0.00000,-1.00000
 1008,  768,     1008,  796,    1.00000,-0.00000
 1008,  796,      912,  796,    0.00000,1.00000
  912,  796,      912,  768,    -1.00000,-0.00000
  912,  576,     1008,  576,    0.00000,-1.00000
 1008,  576,     1008,  604,    1.00000,-0.00000
 1008,  604,      912,  604,    0.00000,1.00000
  912,  604,      912,  576,    -1.00000,-0.00000
 1152,  816,     1248,  816,    0.00000,-1.00000
 1248,  816,     1248,  844,    1.00000,-0.00000
 1248,  844,     1152,  844,    0.00000,1.00000
 1152,  844,     1152,  816,    -1.00000,-0.00000
 1152,  720,     1248,  720,    0.00000,-1.00000
 1248,  720,     1248,  748,    1.00000,-0.00000
 1248,  748,     1152,  748,    0.00000,1.00000
 1152,  748,     1152,  720,    -1.00000,-0.00000
 1152,  624,     1248,  624,    0.00000,-1.00000
 1248,  624,     1248,  652,    1.00000,-0.00000
 1248,  652,     1152,  652,    0.00000,1.00000
 1152,  652,     1152,  624,    -1.00000,-0.00000
 1152,  528,     1248,  528,    0.00000,-1.00000
 1248,  528,     1248,  556,    1.00000,-0.00000
 1248,  556,     1152,  556,    0.00000,1.00000
 1152,  556,     1152,  528,    -1.00000,-0.00000
 1392,  864,     1488,  864,    0.00000,-1.00000
 1488,  864,     1488,  892,    1.00000,-0.00000
 1488,  892,     1392,  892,    0.00000,1.00000
 1392,  892,     1392,  864,    -1.00000,-0.00000
 1392,  672,     1488,  672,    0.00000,-1.00000
 1488,  672,     1488,  700,    1.00000,-0.00000
 1488,  700,     1392,  700,    0.00000,1.00000
 1392,  700,     1392,  672,    -1.00000,-0.00000
 1392,  480,     1488,  480,    0.00000,-1.00000
 1488,  480,     1488,  508,    1.00000,-0.00000
 1488,  508,     1392,  508,    0.00000,1.00000
 1392,  508,     1392,  480,    -1.00000,-0.00000
@EvtMap  31
  480, 1152,     3,  1,   0
  528, 1152,     3,  1,   0
  576, 1152,     3,  1,   0
  720, 1152,     3,  1,   0
  768, 1152,     3,  1,   0
  816, 1152,     3,  1,   0
 1008, 1152,     3,  1,   0
 1056, 1152,     3,  1,   0
 1104, 1152,     3,  1,   0
 1296, 1152,     3,  1,   0
 1344, 1152,     3,  1,   0
 1392, 1152,     3,  1,   0
 1440, 1152,     3,  1,   0
 1488, 1152,     3,  1,   0
 1536, 1152,     3,  1,   0
 2064,  864,     3,  1,   0
 2112,  864,     3,  1,   0
 2160,  864,     3,  1,   0
 2304,  864,     3,  1,   0
 2352,  864,     3,  1,   0
 2496,  864,     3,  1,   0
 2544,  864,     3,  1,   0
 2592,  864,     3,  1,   0
 1632,  432,     3,  2,   0
 2000,  624,     3,  2,   0
  384,  960,     3,  4,   0
  912,  960,     3,  4,   0
 1200,  850,     2,  10,   0
 1416,  376,     2,  10,   0
 2832,  624,     2,  20,   0
   16,  864,     1,  0,   0
