@MapData  60, 20, 48, 48, ../image/mapchip3.png
@MapAttr  20, 15
0, 0, 0, 0, 0, 0, 0, 0, 0, 0, 0, 0, 0, 0, 0, 0, 0, 0, 0, 0, 
0, 0, 0, 0, 0, 0, 0, 0, 0, 0, 0, 0, 0, 0, 0, 0, 0, 0, 0, 0, 
1, 0, 0, 0, 0, 0, 0, 0, 0, 0, 0, 0, 0, 0, 0, 0, 0, 0, 0, 0, 
0, 0, 0, 0, 0, 0, 0, 0, 0, 0, 0, 0, 0, 0, 0, 0, 0, 0, 0, 0, 
0, 0, 0, 0, 0, 0, 0, 0, 0, 0, 0, 0, 0, 0, 0, 0, 0, 0, 0, 0, 
0, 0, 0, 0, 0, 0, 0, 0, 0, 0, 0, 0, 0, 0, 0, 0, 0, 0, 0, 0, 
0, 0, 0, 0, 0, 0, 0, 0, 0, 0, 0, 0, 0, 0, 0, 0, 0, 0, 0, 0, 
0, 0, 0, 0, 0, 0, 0, 0, 0, 0, 0, 0, 0, 0, 0, 0, 0, 0, 0, 0, 
0, 0, 0, 0, 0, 0, 0, 0, 0, 0, 0, 0, 0, 0, 0, 0, 0, 0, 0, 0, 
0, 0, 0, 0, 0, 0, 0, 0, 0, 0, 0, 0, 0, 0, 0, 0, 0, 0, 0, 0, 
0, 0, 0, 0, 0, 0, 0, 0, 0, 0, 0, 0, 0, 0, 0, 0, 0, 0, 0, 0, 
0, 0, 0, 0, 0, 0, 0, 0, 0, 0, 0, 0, 0, 0, 0, 0, 0, 0, 0, 0, 
0, 0, 0, 0, 0, 0, 0, 0, 0, 0, 0, 0, 0, 0, 0, 0, 0, 0, 0, 0, 
0, 0, 0, 0, 0, 0, 0, 0, 0, 0, 0, 0, 0, 0, 0, 0, 0, 0, 0, 0, 
0, 0, 0, 0, 0, 0, 0, 0, 0, 0, 0, 0, 0, 0, 0, 0, 0, 0, 0, 0, 
@Back
5011, 5011, 5011, 5011, 5011, 5011, 5011, 5011, 5011, 5011, 5011, 5011, 5011, 5011, 5011, 5011, 5011, 5011, 5011, 5011, 5011, 5011, 5011, 5011, 5011, 5011, 5011, 5011, 5011, 5011, 5011, 5011, 5011, 5011, 5011, 5011, 5011, 5011, 5011, 5011, 5011, 5011, 5011, 5011, 5011, 5011, 5011, 5011, 5011, 5011, 5011, 5011, 5011, 5011, 5011, 5011, 5011, 5011, 5011, 5011, 
5011, 5011, 5011, 5011, 5011, 5011, 5011, 5011, 5011, 5011, 5011, 5011, 5011, 5011, 5011, 5011, 5011, 5011, 5011, 5011, 5011, 5011, 5011, 5011, 5011, 5011, 5011, 5011, 5011, 5011, 5011, 5011, 5011, 5011, 5011, 5011, 5011, 5011, 5011, 5011, 5011, 5011, 5011, 5011, 5011, 5011, 5011, 5011, 5011, 5011, 5011, 5011, 5011, 5011, 5011, 5011, 5011, 5011, 5011, 5011, 
5011, 5011, 5011, 5011, 5011, 5011, 5011, 5011, 5011, 5011, 5011, 5011, 5011, 5011, 5011, 5011, 5011, 5011, 5011, 5011, 5011, 5011, 5011, 5011, 5011, 5011, 5011, 5011, 5011, 5011, 5011, 5011, 5011, 5011, 5011, 5011, 5011, 5011, 5011, 5011, 5011, 5011, 5011, 5011, 5011, 5011, 5011, 5011, 5011, 5011, 5011, 5011, 5011, 5011, 5011, 5011, 5011, 5011, 5011, 5011, 
5011, 5011, 5011, 5011, 5011, 5011, 5011, 5011, 5011, 5011, 5011, 5011, 5011, 5011, 5011, 5011, 5011, 5011, 5011, 5011, 5011, 5011, 5011, 5011, 5011, 5011, 5011, 5011, 5011, 5011, 5011, 5011, 5011, 5011, 5011, 5011, 5011, 5011, 5011, 5011, 5011, 5011, 5011, 5011, 5011, 5011, 5011, 5011, 5011, 5011, 5011, 5011, 5011, 5011, 5011, 5011, 5011, 5011, 5011, 5011, 
5011, 5011, 5011, 5011, 5011, 5011, 5011, 5011, 5011, 5011, 5011, 5011, 5011, 5011, 5011, 5011, 5011, 5011, 5011, 5011, 5011, 5011, 5011, 5011, 5011, 5011, 5011, 5011, 5011, 5011, 5011, 5011, 5011, 5011, 5011, 5011, 5011, 5011, 5011, 5011, 5011, 5011, 5011, 5011, 5011, 5011, 5011, 5011, 5011, 5011, 5011, 5011, 5011, 5011, 5011, 5011, 5011, 5011, 5011, 5011, 
5011, 5011, -1, -1, -1, -1, -1, -1, -1, -1, -1, -1, -1, -1, -1, -1, -1, -1, 5011, 5011, 5011, 5011, 5011, 5011, 5011, 5011, 5011, 5011, 5011, 5011, 5011, 5011, 5011, 5011, 5011, 5011, 5011, 5011, 5011, 5011, 5011, 5011, 5011, 5011, 5011, 5011, 5011, 5011, 5011, 5011, 5011, 5011, 5011, 5011, 5011, 5011, 5011, 5011, 5011, 5011, 
5011, 5011, -1, -1, -1, -1, -1, -1, -1, -1, -1, -1, -1, -1, -1, -1, -1, -1, 5011, 5011, 5011, 5011, 5011, 5011, 5011, 5011, 5011, 5011, 5011, 5011, 5011, 5011, 5011, 5011, 5011, 5011, 5011, 5011, 5011, 5011, 5011, 5011, 5011, 5011, 5011, 5011, 5011, 5011, 5011, 5011, 5011, 5011, 5011, 5011, 5011, 5011, 5011, 5011, 5011, 5011, 
5011, 5011, -1, -1, -1, -1, -1, -1, -1, -1, -1, -1, -1, -1, -1, -1, -1, -1, 5011, 5011, 5011, 5011, 5011, 5011, 5011, 5011, 5011, 5011, 5011, 5011, 5011, 5011, 5011, 5011, 5011, 5011, 5011, 5011, 5011, 5011, 5011, 5011, 5011, 5011, 5011, 5011, 5011, 5011, 5011, 5011, 5011, 5011, 5011, 5011, 5011, 5011, 5011, 5011, 5011, 5011, 
5011, 5011, -1, -1, -1, -1, -1, -1, -1, -1, -1, -1, -1, -1, -1, -1, -1, -1, 5011, 5011, 5011, 5011, 5011, 5011, 5011, 5011, 5011, 5011, 5011, 5011, 5011, 5011, 5011, 5011, 5011, 5011, 5011, 5011, 5011, 5011, 5011, 5011, 5011, 5011, 5011, 5011, 5011, 5011, 5011, 5011, 5011, 5011, 5011, 5011, 5011, 5011, 5011, 5011, 5011, 5011, 
5011, 5011, -1, -1, -1, -1, -1, -1, -1, -1, -1, -1, -1, -1, -1, -1, -1, -1, 5011, 5011, 5011, 5011, 5011, 5011, 5011, 5011, 5011, 5011, 5011, 5011, 5011, 5011, 5011, 5011, 5011, 5011, 5011, 5011, 5011, 5011, 5011, 5011, 5011, 5011, 5011, 5011, 5011, 5011, 5011, 5011, 5011, 5011, 5011, 5011, 5011, 5011, 5011, 5011, 5011, 5011, 
5011, 5011, -1, -1, -1, -1, -1, -1, -1, -1, -1, -1, -1, -1, -1, -1, -1, -1, 5011, 5011, 5011, 5011, 5011, 5011, 5011, 5011, 5011, 5011, 5011, 5011, 5011, 5011, 5011, 5011, 5011, 5011, 5011, 5011, 5011, 5011, 5011, 5011, 5011, 5011, 5011, 5011, 5011, 5011, 5011, 5011, 5011, 5011, 5011, 5011, 5011, 5011, 5011, 5011, 5011, 5011, 
5011, 5011, -1, -1, -1, -1, -1, -1, -1, -1, -1, -1, -1, -1, -1, -1, -1, -1, 5011, 5011, 5011, 5011, 5011, 5011, 5011, 5011, 5011, 5011, 5011, 5011, 5011, 5011, 5011, 5011, 5011, 5011, 5011, 5011, 5011, 5011, 5011, 5011, 5011, 5011, 5011, 5011, 5011, 5011, 5011, 5011, 5011, 5011, 5011, 5011, 5011, 5011, 5011, 5011, 5011, 5011, 
5011, 5011, -1, -1, -1, -1, -1, -1, -1, -1, -1, -1, -1, -1, -1, -1, -1, -1, 5011, 5011, 5011, 5011, 5011, 5011, 5011, 5011, 5011, 5011, 5011, 5011, 5011, 5011, 5011, 5011, 5011, 5011, 5011, 5011, 5011, 5011, 5011, 5011, 5011, 5011, 5011, 5011, 5011, 5011, 5011, 5011, 5011, 5011, 5011, 5011, 5011, 5011, 5011, 5011, 5011, 5011, 
5011, 5011, -1, -1, -1, -1, -1, -1, -1, -1, -1, -1, -1, -1, -1, -1, -1, -1, 5011, 5011, 5011, 5011, 5011, 5011, 5011, 5011, 5011, 5011, 5011, 5011, 5011, 5011, 5011, 5011, 5011, 5011, 5011, 5011, 5011, 5011, 5011, 5011, 5011, 5011, 5011, 5011, 5011, 5011, 5011, 5011, 5011, 5011, 5011, 5011, 5011, 5011, 5011, 5011, 5011, 5011, 
5011, 5011, -1, -1, -1, -1, -1, -1, -1, -1, -1, -1, -1, -1, -1, -1, -1, -1, 5011, 5011, 5011, 5011, 5011, 5011, 5011, 5011, 5011, 5011, 5011, 5011, 5011, 5011, 5011, 5011, 5011, 5011, 5011, 5011, 5011, 5011, 5011, 5011, 5011, 5011, 5011, 5011, 5011, 5011, 5011, 5011, 5011, 5011, 5011, 5011, 5011, 5011, 5011, 5011, 5011, 5011, 
5011, 5011, -1, -1, -1, -1, -1, -1, -1, -1, -1, -1, -1, -1, -1, -1, -1, -1, 5011, 5011, 5011, 5011, 5011, 5011, 5011, 5011, 5011, 5011, 5011, 5011, 5011, 5011, 5011, 5011, 5011, 5011, 5011, 5011, 5011, 5011, 5011, 5011, 5011, 5011, 5011, 5011, 5011, 5011, 5011, 5011, 5011, 5011, 5011, 5011, 5011, 5011, 5011, 5011, 5011, 5011, 
5011, 5011, 5011, 5011, 5011, 5011, 5011, 5011, 5011, 5011, 5011, 5011, 5011, 5011, 5011, 5011, 5011, 5011, 5011, 5011, 5011, 5011, 5011, 5011, 5011, 5011, 5011, 5011, 5011, 5011, 5011, 5011, 5011, 5011, 5011, 5011, 5011, 5011, 5011, 5011, 5011, 5011, 5011, 5011, 5011, 5011, 5011, 5011, 5011, 5011, 5011, 5011, 5011, 5011, 5011, 5011, 5011, 5011, 5011, 5011, 
5011, 5011, 5011, 5011, 5011, 5011, 5011, 5011, 5011, 5011, 5011, 5011, 5011, 5011, 5011, 5011, 5011, 5011, 5011, 5011, 5011, 5011, 5011, 5011, 5011, 5011, 5011, 5011, 5011, 5011, 5011, 5011, 5011, 5011, 5011, 5011, 5011, 5011, 5011, 5011, 5011, 5011, 5011, 5011, 5011, 5011, 5011, 5011, 5011, 5011, 5011, 5011, 5011, 5011, 5011, 5011, 5011, 5011, 5011, 5011, 
5011, 5011, 5011, 5011, 5011, 5011, 5011, 5011, 5011, 5011, 5011, 5011, 5011, 5011, 5011, 5011, 5011, 5011, 5011, 5011, 5011, 5011, 5011, 5011, 5011, 5011, 5011, 5011, 5011, 5011, 5011, 5011, 5011, 5011, 5011, 5011, 5011, 5011, 5011, 5011, 5011, 5011, 5011, 5011, 5011, 5011, 5011, 5011, 5011, 5011, 5011, 5011, 5011, 5011, 5011, 5011, 5011, 5011, 5011, 5011, 
5011, 5011, 5011, 5011, 5011, 5011, 5011, 5011, 5011, 5011, 5011, 5011, 5011, 5011, 5011, 5011, 5011, 5011, 5011, 5011, 5011, 5011, 5011, 5011, 5011, 5011, 5011, 5011, 5011, 5011, 5011, 5011, 5011, 5011, 5011, 5011, 5011, 5011, 5011, 5011, 5011, 5011, 5011, 5011, 5011, 5011, 5011, 5011, 5011, 5011, 5011, 5011, 5011, 5011, 5011, 5011, 5011, 5011, 5011, 5011, 
@Fore
-1, -1, -1, -1, -1, -1, -1, -1, -1, -1, -1, -1, -1, -1, -1, -1, -1, -1, -1, -1, -1, -1, -1, -1, -1, -1, -1, -1, -1, -1, -1, -1, -1, -1, -1, -1, -1, -1, -1, -1, -1, -1, -1, -1, -1, -1, -1, -1, -1, -1, -1, -1, -1, -1, -1, -1, -1, -1, -1, -1, 
-1, -1, -1, -1, -1, -1, -1, -1, -1, -1, -1, -1, -1, -1, -1, -1, -1, -1, -1, -1, -1, -1, -1, -1, -1, -1, -1, -1, -1, -1, -1, -1, -1, -1, -1, -1, -1, -1, -1, -1, -1, -1, -1, -1, -1, -1, -1, -1, -1, -1, -1, -1, -1, -1, -1, -1, -1, -1, -1, -1, 
-1, -1, -1, -1, -1, -1, -1, -1, -1, -1, -1, -1, -1, -1, -1, -1, -1, -1, -1, -1, -1, -1, -1, -1, -1, -1, -1, -1, -1, -1, -1, -1, -1, -1, -1, -1, -1, -1, -1, -1, -1, -1, -1, -1, -1, -1, -1, -1, -1, -1, -1, -1, -1, -1, -1, -1, -1, -1, -1, -1, 
-1, -1, -1, -1, -1, -1, -1, -1, -1, -1, -1, -1, -1, -1, -1, -1, -1, -1, -1, -1, -1, -1, -1, -1, -1, -1, -1, -1, -1, -1, -1, -1, -1, -1, -1, -1, -1, -1, -1, -1, -1, -1, -1, -1, -1, -1, -1, -1, -1, -1, -1, -1, -1, -1, -1, -1, -1, -1, -1, -1, 
-1, -1, -1, -1, -1, -1, -1, -1, -1, -1, -1, -1, -1, -1, -1, -1, -1, -1, -1, -1, -1, -1, -1, -1, -1, -1, -1, -1, -1, -1, -1, -1, -1, -1, -1, -1, -1, -1, -1, -1, -1, -1, -1, -1, -1, -1, -1, -1, -1, -1, -1, -1, -1, -1, -1, -1, -1, -1, -1, -1, 
-1, -1, -1, -1, -1, -1, -1, -1, -1, -1, -1, -1, -1, -1, -1, -1, -1, -1, -1, -1, -1, -1, -1, -1, -1, -1, -1, -1, -1, -1, -1, -1, -1, -1, -1, -1, -1, -1, -1, -1, -1, -1, -1, -1, -1, -1, -1, -1, -1, -1, -1, -1, -1, -1, -1, -1, -1, -1, -1, -1, 
-1, -1, -1, -1, -1, -1, -1, -1, -1, -1, -1, -1, -1, -1, -1, -1, -1, -1, -1, -1, -1, -1, -1, -1, -1, -1, -1, -1, -1, -1, -1, -1, -1, -1, -1, -1, -1, -1, -1, -1, -1, -1, -1, -1, -1, -1, -1, -1, -1, -1, -1, -1, -1, -1, -1, -1, -1, -1, -1, -1, 
-1, -1, -1, -1, -1, -1, -1, -1, -1, -1, -1, -1, -1, -1, -1, -1, -1, -1, -1, -1, -1, -1, -1, -1, -1, -1, -1, -1, -1, -1, -1, -1, -1, -1, -1, -1, -1, -1, -1, -1, -1, -1, -1, -1, -1, -1, -1, -1, -1, -1, -1, -1, -1, -1, -1, -1, -1, -1, -1, -1, 
-1, -1, -1, -1, -1, -1, -1, -1, -1, -1, -1, -1, -1, -1, -1, -1, -1, -1, -1, -1, -1, -1, -1, -1, -1, -1, -1, -1, -1, -1, -1, -1, -1, -1, -1, -1, -1, -1, -1, -1, -1, -1, -1, -1, -1, -1, -1, -1, -1, -1, -1, -1, -1, -1, -1, -1, -1, -1, -1, -1, 
-1, -1, -1, -1, -1, -1, -1, -1, -1, -1, -1, -1, -1, -1, -1, -1, -1, -1, -1, -1, -1, -1, -1, -1, -1, -1, -1, -1, -1, -1, -1, -1, -1, -1, -1, -1, -1, -1, -1, -1, -1, -1, -1, -1, -1, -1, -1, -1, -1, -1, -1, -1, -1, -1, -1, -1, -1, -1, -1, -1, 
-1, -1, -1, -1, -1, -1, -1, -1, -1, -1, -1, -1, -1, -1, -1, -1, -1, -1, -1, -1, -1, -1, -1, -1, -1, -1, -1, -1, -1, -1, -1, -1, -1, -1, -1, -1, -1, -1, -1, -1, -1, -1, -1, -1, -1, -1, -1, -1, -1, -1, -1, -1, -1, -1, -1, -1, -1, -1, -1, -1, 
-1, -1, -1, -1, -1, -1, -1, -1, -1, -1, -1, -1, -1, -1, -1, -1, -1, -1, -1, -1, -1, -1, -1, -1, -1, -1, -1, -1, -1, -1, -1, -1, -1, -1, -1, -1, -1, -1, -1, -1, -1, -1, -1, -1, -1, -1, -1, -1, -1, -1, -1, -1, -1, -1, -1, -1, -1, -1, -1, -1, 
-1, -1, -1, -1, -1, -1, -1, -1, -1, -1, -1, -1, -1, -1, -1, -1, -1, -1, -1, -1, -1, -1, -1, -1, -1, -1, -1, -1, -1, -1, -1, -1, -1, -1, -1, -1, -1, -1, -1, -1, -1, -1, -1, -1, -1, -1, -1, -1, -1, -1, -1, -1, -1, -1, -1, -1, -1, -1, -1, -1, 
-1, -1, -1, -1, -1, -1, -1, -1, -1, -1, -1, -1, -1, -1, -1, -1, -1, -1, -1, -1, -1, -1, -1, -1, -1, -1, -1, -1, -1, -1, -1, -1, -1, -1, -1, -1, -1, -1, -1, -1, -1, -1, -1, -1, -1, -1, -1, -1, -1, -1, -1, -1, -1, -1, -1, -1, -1, -1, -1, -1, 
-1, -1, -1, -1, -1, -1, -1, -1, -1, -1, -1, -1, -1, -1, -1, -1, -1, -1, -1, -1, -1, -1, -1, -1, -1, -1, -1, -1, -1, -1, -1, -1, -1, -1, -1, -1, -1, -1, -1, -1, -1, -1, -1, -1, -1, -1, -1, -1, -1, -1, -1, -1, -1, -1, -1, -1, -1, -1, -1, -1, 
-1, -1, -1, -1, -1, -1, -1, -1, -1, -1, -1, -1, -1, -1, -1, -1, -1, -1, -1, -1, -1, -1, -1, -1, -1, -1, -1, -1, -1, -1, -1, -1, -1, -1, -1, -1, -1, -1, -1, -1, -1, -1, -1, -1, -1, -1, -1, -1, -1, -1, -1, -1, -1, -1, -1, -1, -1, -1, -1, -1, 
-1, -1, -1, -1, -1, -1, -1, -1, -1, -1, -1, -1, -1, -1, -1, -1, -1, -1, -1, -1, -1, -1, -1, -1, -1, -1, -1, -1, -1, -1, -1, -1, -1, -1, -1, -1, -1, -1, -1, -1, -1, -1, -1, -1, -1, -1, -1, -1, -1, -1, -1, -1, -1, -1, -1, -1, -1, -1, -1, -1, 
-1, -1, -1, -1, -1, -1, -1, -1, -1, -1, -1, -1, -1, -1, -1, -1, -1, -1, -1, -1, -1, -1, -1, -1, -1, -1, -1, -1, -1, -1, -1, -1, -1, -1, -1, -1, -1, -1, -1, -1, -1, -1, -1, -1, -1, -1, -1, -1, -1, -1, -1, -1, -1, -1, -1, -1, -1, -1, -1, -1, 
-1, -1, -1, -1, -1, -1, -1, -1, -1, -1, -1, -1, -1, -1, -1, -1, -1, -1, -1, -1, -1, -1, -1, -1, -1, -1, -1, -1, -1, -1, -1, -1, -1, -1, -1, -1, -1, -1, -1, -1, -1, -1, -1, -1, -1, -1, -1, -1, -1, -1, -1, -1, -1, -1, -1, -1, -1, -1, -1, -1, 
-1, -1, -1, -1, -1, -1, -1, -1, -1, -1, -1, -1, -1, -1, -1, -1, -1, -1, -1, -1, -1, -1, -1, -1, -1, -1, -1, -1, -1, -1, -1, -1, -1, -1, -1, -1, -1, -1, -1, -1, -1, -1, -1, -1, -1, -1, -1, -1, -1, -1, -1, -1, -1, -1, -1, -1, -1, -1, -1, -1, 
@MapLine  4
   96,  768,      864,  768,    0.00000,-1.00000
  860,  240,       96,  236,    -0.00524,0.99999
  108,  236,       96,  768,    0.99975,0.02255
  864,  768,      852,  236,    -0.99975,0.02255
@EvtMap  2
  727,  391,     3,  8,   0
  153,  718,     1,  0,   0
