@MapData  60, 20, 48, 48, ../image/mapchip3ver2.png
@MapAttr  20, 15
0, 0, 0, 0, 0, 0, 0, 0, 0, 0, 0, 0, 0, 0, 0, 0, 0, 0, 0, 0, 
0, 0, 0, 0, 0, 0, 0, 0, 0, 0, 0, 0, 0, 0, 0, 0, 0, 0, 0, 0, 
1, 0, 0, 0, 0, 0, 0, 0, 0, 0, 0, 0, 0, 0, 0, 0, 0, 0, 0, 0, 
0, 0, 0, 0, 0, 0, 0, 0, 0, 0, 0, 0, 0, 0, 0, 0, 0, 0, 0, 0, 
0, 0, 0, 0, 0, 0, 0, 0, 0, 0, 0, 0, 0, 0, 0, 0, 0, 0, 0, 0, 
0, 0, 0, 0, 0, 0, 0, 0, 0, 0, 0, 0, 0, 0, 0, 0, 0, 0, 0, 0, 
0, 0, 0, 0, 0, 0, 0, 0, 0, 0, 0, 0, 0, 0, 0, 0, 0, 0, 0, 0, 
0, 0, 0, 0, 0, 0, 0, 0, 0, 0, 0, 0, 0, 0, 0, 0, 0, 0, 0, 0, 
0, 0, 0, 0, 0, 0, 0, 0, 0, 0, 0, 0, 0, 0, 0, 0, 0, 0, 0, 0, 
0, 0, 0, 0, 0, 0, 0, 0, 0, 0, 0, 0, 0, 0, 0, 0, 0, 0, 0, 0, 
0, 0, 0, 0, 0, 0, 0, 0, 0, 0, 0, 0, 0, 0, 0, 0, 0, 0, 0, 0, 
0, 0, 0, 0, 0, 0, 0, 0, 0, 0, 0, 0, 0, 0, 0, 0, 0, 0, 0, 0, 
0, 0, 0, 0, 0, 0, 0, 0, 0, 0, 0, 0, 0, 0, 0, 0, 0, 0, 0, 0, 
0, 0, 0, 0, 0, 0, 0, 0, 0, 0, 0, 0, 0, 0, 0, 0, 0, 0, 0, 0, 
0, 0, 0, 0, 0, 0, 0, 0, 0, 0, 0, 0, 0, 0, 0, 0, 0, 0, 0, 0, 
@Back
3011, 3011, 3011, 3011, 3011, 3011, 3011, 3011, 3011, 3011, 3011, 3011, 3011, 3011, 3011, 3011, 3011, 3011, 3011, 3011, 3011, 3011, 3011, 3011, 3011, 3011, 3011, 3011, 3011, 3011, 3011, 3011, 3011, 3011, 3011, 3011, 3011, 3011, 3011, 3011, 3011, 3011, 3011, 3011, 3011, 3011, 3011, 3011, 3011, 3011, 3011, 3011, 3011, 3011, 3011, 3011, 3011, 3011, 3011, 3011, 
3011, 3011, 3011, 3011, 3011, 3011, 3011, 3011, 3011, 3011, 3011, 3011, 3011, 3011, 3011, 3011, 3011, 3011, 3011, 3011, 3011, 3011, 3011, 3011, 3011, 3011, 3011, 3011, 3011, 3011, 3011, 3011, 3011, 3011, 3011, 3011, 3011, 3011, 3011, 3011, 3011, 3011, 3011, 3011, 3011, 3011, 3011, 3011, 3011, 3011, 3011, 3011, 3011, 3011, 3011, 3011, 3011, 3011, 3011, 3011, 
3011, 3011, 3011, 3011, 3011, 3011, 3011, 3011, 3011, 3011, 3011, 3011, 3011, 3011, 3011, 3011, 3011, 3011, 3011, 3011, 3011, 3011, 3011, 3011, 3011, 3011, 3011, 3011, 3011, 3011, 3011, 3011, 3011, 3011, 3011, 3011, 3011, 3011, 3011, 3011, 3011, 3011, 3011, 3011, 3011, 3011, 3011, 3011, 3011, 3011, 3011, 3011, 3011, 3011, 3011, 3011, 3011, 3011, 3011, 3011, 
3011, 3011, 3011, 3011, 3011, 3011, 3011, 3011, 3011, 3011, 3011, 3011, 3011, 3011, 3011, 3011, 3011, 3011, 3011, 3011, 3011, 3011, 3011, 3011, 3011, 3011, 3011, 3011, 3011, 3011, 3011, 3011, 3011, 3011, 3011, 3011, 3011, 3011, 3011, 3011, 3011, 3011, 3011, 3011, 3011, 3011, 3011, 3011, 3011, 3011, 3011, 3011, 3011, 3011, 3011, 3011, 3011, 3011, 3011, 3011, 
3011, 3011, 3011, 3011, 3011, 3011, 3011, 3011, 3011, 3011, 3011, 3011, 3011, 3011, 3011, 3011, 3011, 3011, 3011, 3011, 3011, 3011, 3011, 3011, 3011, 3011, 3011, 3011, 3011, 3011, 3011, 3011, 3011, 3011, 3011, 3011, 3011, 3011, 3011, 3011, 3011, 3011, 3011, 3011, 3011, 3011, 3011, 3011, 3011, 3011, 3011, 3011, 3011, 3011, 3011, 3011, 3011, 3011, 3011, 3011, 
3011, 3011, -1, -1, -1, -1, -1, -1, -1, -1, -1, -1, -1, -1, -1, -1, -1, -1, 3011, 3011, 3011, 3011, 3011, 3011, 3011, 3011, 3011, 3011, 3011, 3011, 3011, 3011, 3011, 3011, 3011, 3011, 3011, 3011, 3011, 3011, 3011, 3011, 3011, 3011, 3011, 3011, 3011, 3011, 3011, 3011, 3011, 3011, 3011, 3011, 3011, 3011, 3011, 3011, 3011, 3011, 
3011, 3011, -1, -1, -1, -1, -1, -1, -1, -1, -1, -1, -1, -1, -1, -1, -1, -1, 3011, 3011, 3011, 3011, 3011, 3011, 3011, 3011, 3011, 3011, 3011, 3011, 3011, 3011, 3011, 3011, 3011, 3011, 3011, 3011, 3011, 3011, 3011, 3011, 3011, 3011, 3011, 3011, 3011, 3011, 3011, 3011, 3011, 3011, 3011, 3011, 3011, 3011, 3011, 3011, 3011, 3011, 
3011, 3011, -1, -1, -1, -1, -1, -1, -1, -1, -1, -1, -1, -1, -1, -1, -1, -1, 3011, 3011, 3011, 3011, 3011, 3011, 3011, 3011, 3011, 3011, 3011, 3011, 3011, 3011, 3011, 3011, 3011, 3011, 3011, 3011, 3011, 3011, 3011, 3011, 3011, 3011, 3011, 3011, 3011, 3011, 3011, 3011, 3011, 3011, 3011, 3011, 3011, 3011, 3011, 3011, 3011, 3011, 
3011, 3011, -1, -1, -1, -1, -1, -1, -1, -1, -1, -1, -1, -1, -1, -1, -1, -1, 3011, 3011, 3011, 3011, 3011, 3011, 3011, 3011, 3011, 3011, 3011, 3011, 3011, 3011, 3011, 3011, 3011, 3011, 3011, 3011, 3011, 3011, 3011, 3011, 3011, 3011, 3011, 3011, 3011, 3011, 3011, 3011, 3011, 3011, 3011, 3011, 3011, 3011, 3011, 3011, 3011, 3011, 
3011, 3011, -1, -1, -1, -1, -1, -1, -1, -1, -1, -1, -1, -1, -1, -1, -1, -1, 3011, 3011, 3011, 3011, 3011, 3011, 3011, 3011, 3011, 3011, 3011, 3011, 3011, 3011, 3011, 3011, 3011, 3011, 3011, 3011, 3011, 3011, 3011, 3011, 3011, 3011, 3011, 3011, 3011, 3011, 3011, 3011, 3011, 3011, 3011, 3011, 3011, 3011, 3011, 3011, 3011, 3011, 
3011, 3011, -1, -1, -1, -1, -1, -1, -1, -1, -1, -1, -1, -1, -1, -1, -1, -1, 3011, 3011, 3011, 3011, 3011, 3011, 3011, 3011, 3011, 3011, 3011, 3011, 3011, 3011, 3011, 3011, 3011, 3011, 3011, 3011, 3011, 3011, 3011, 3011, 3011, 3011, 3011, 3011, 3011, 3011, 3011, 3011, 3011, 3011, 3011, 3011, 3011, 3011, 3011, 3011, 3011, 3011, 
3011, 3011, -1, -1, -1, -1, -1, -1, -1, -1, -1, -1, -1, -1, -1, -1, -1, -1, 3011, 3011, 3011, 3011, 3011, 3011, 3011, 3011, 3011, 3011, 3011, 3011, 3011, 3011, 3011, 3011, 3011, 3011, 3011, 3011, 3011, 3011, 3011, 3011, 3011, 3011, 3011, 3011, 3011, 3011, 3011, 3011, 3011, 3011, 3011, 3011, 3011, 3011, 3011, 3011, 3011, 3011, 
3011, 3011, -1, -1, -1, -1, -1, -1, -1, -1, -1, -1, -1, -1, -1, -1, -1, -1, 3011, 3011, 3011, 3011, 3011, 3011, 3011, 3011, 3011, 3011, 3011, 3011, 3011, 3011, 3011, 3011, 3011, 3011, 3011, 3011, 3011, 3011, 3011, 3011, 3011, 3011, 3011, 3011, 3011, 3011, 3011, 3011, 3011, 3011, 3011, 3011, 3011, 3011, 3011, 3011, 3011, 3011, 
3011, 3011, -1, -1, -1, -1, -1, -1, -1, -1, -1, -1, -1, -1, -1, -1, -1, -1, 3011, 3011, 3011, 3011, 3011, 3011, 3011, 3011, 3011, 3011, 3011, 3011, 3011, 3011, 3011, 3011, 3011, 3011, 3011, 3011, 3011, 3011, 3011, 3011, 3011, 3011, 3011, 3011, 3011, 3011, 3011, 3011, 3011, 3011, 3011, 3011, 3011, 3011, 3011, 3011, 3011, 3011, 
3011, 3011, -1, -1, -1, -1, -1, -1, -1, -1, -1, -1, -1, -1, -1, -1, -1, -1, 3011, 3011, 3011, 3011, 3011, 3011, 3011, 3011, 3011, 3011, 3011, 3011, 3011, 3011, 3011, 3011, 3011, 3011, 3011, 3011, 3011, 3011, 3011, 3011, 3011, 3011, 3011, 3011, 3011, 3011, 3011, 3011, 3011, 3011, 3011, 3011, 3011, 3011, 3011, 3011, 3011, 3011, 
3011, 3011, -1, -1, -1, -1, -1, -1, -1, -1, -1, -1, -1, -1, -1, -1, -1, -1, 3011, 3011, 3011, 3011, 3011, 3011, 3011, 3011, 3011, 3011, 3011, 3011, 3011, 3011, 3011, 3011, 3011, 3011, 3011, 3011, 3011, 3011, 3011, 3011, 3011, 3011, 3011, 3011, 3011, 3011, 3011, 3011, 3011, 3011, 3011, 3011, 3011, 3011, 3011, 3011, 3011, 3011, 
3011, 3011, 3011, 3011, 3011, 3011, 3011, 3011, 3011, 3011, 3011, 3011, 3011, 3011, 3011, 3011, 3011, 3011, 3011, 3011, 3011, 3011, 3011, 3011, 3011, 3011, 3011, 3011, 3011, 3011, 3011, 3011, 3011, 3011, 3011, 3011, 3011, 3011, 3011, 3011, 3011, 3011, 3011, 3011, 3011, 3011, 3011, 3011, 3011, 3011, 3011, 3011, 3011, 3011, 3011, 3011, 3011, 3011, 3011, 3011, 
3011, 3011, 3011, 3011, 3011, 3011, 3011, 3011, 3011, 3011, 3011, 3011, 3011, 3011, 3011, 3011, 3011, 3011, 3011, 3011, 3011, 3011, 3011, 3011, 3011, 3011, 3011, 3011, 3011, 3011, 3011, 3011, 3011, 3011, 3011, 3011, 3011, 3011, 3011, 3011, 3011, 3011, 3011, 3011, 3011, 3011, 3011, 3011, 3011, 3011, 3011, 3011, 3011, 3011, 3011, 3011, 3011, 3011, 3011, 3011, 
3011, 3011, 3011, 3011, 3011, 3011, 3011, 3011, 3011, 3011, 3011, 3011, 3011, 3011, 3011, 3011, 3011, 3011, 3011, 3011, 3011, 3011, 3011, 3011, 3011, 3011, 3011, 3011, 3011, 3011, 3011, 3011, 3011, 3011, 3011, 3011, 3011, 3011, 3011, 3011, 3011, 3011, 3011, 3011, 3011, 3011, 3011, 3011, 3011, 3011, 3011, 3011, 3011, 3011, 3011, 3011, 3011, 3011, 3011, 3011, 
3011, 3011, 3011, 3011, 3011, 3011, 3011, 3011, 3011, 3011, 3011, 3011, 3011, 3011, 3011, 3011, 3011, 3011, 3011, 3011, 3011, 3011, 3011, 3011, 3011, 3011, 3011, 3011, 3011, 3011, 3011, 3011, 3011, 3011, 3011, 3011, 3011, 3011, 3011, 3011, 3011, 3011, 3011, 3011, 3011, 3011, 3011, 3011, 3011, 3011, 3011, 3011, 3011, 3011, 3011, 3011, 3011, 3011, 3011, 3011, 
@Fore
-1, -1, -1, -1, -1, -1, -1, -1, -1, -1, -1, -1, -1, -1, -1, -1, -1, -1, -1, -1, -1, -1, -1, -1, -1, -1, -1, -1, -1, -1, -1, -1, -1, -1, -1, -1, -1, -1, -1, -1, -1, -1, -1, -1, -1, -1, -1, -1, -1, -1, -1, -1, -1, -1, -1, -1, -1, -1, -1, -1, 
-1, -1, -1, -1, -1, -1, -1, -1, -1, -1, -1, -1, -1, -1, -1, -1, -1, -1, -1, -1, -1, -1, -1, -1, -1, -1, -1, -1, -1, -1, -1, -1, -1, -1, -1, -1, -1, -1, -1, -1, -1, -1, -1, -1, -1, -1, -1, -1, -1, -1, -1, -1, -1, -1, -1, -1, -1, -1, -1, -1, 
-1, -1, -1, -1, -1, -1, -1, -1, -1, -1, -1, -1, -1, -1, -1, -1, -1, -1, -1, -1, -1, -1, -1, -1, -1, -1, -1, -1, -1, -1, -1, -1, -1, -1, -1, -1, -1, -1, -1, -1, -1, -1, -1, -1, -1, -1, -1, -1, -1, -1, -1, -1, -1, -1, -1, -1, -1, -1, -1, -1, 
-1, -1, -1, -1, -1, -1, -1, -1, -1, -1, -1, -1, -1, -1, -1, -1, -1, -1, -1, -1, -1, -1, -1, -1, -1, -1, -1, -1, -1, -1, -1, -1, -1, -1, -1, -1, -1, -1, -1, -1, -1, -1, -1, -1, -1, -1, -1, -1, -1, -1, -1, -1, -1, -1, -1, -1, -1, -1, -1, -1, 
-1, -1, -1, -1, -1, -1, -1, -1, -1, -1, -1, -1, -1, -1, -1, -1, -1, -1, -1, -1, -1, -1, -1, -1, -1, -1, -1, -1, -1, -1, -1, -1, -1, -1, -1, -1, -1, -1, -1, -1, -1, -1, -1, -1, -1, -1, -1, -1, -1, -1, -1, -1, -1, -1, -1, -1, -1, -1, -1, -1, 
-1, -1, -1, -1, -1, -1, -1, -1, -1, -1, -1, -1, -1, -1, -1, -1, -1, -1, -1, -1, -1, -1, -1, -1, -1, -1, -1, -1, -1, -1, -1, -1, -1, -1, -1, -1, -1, -1, -1, -1, -1, -1, -1, -1, -1, -1, -1, -1, -1, -1, -1, -1, -1, -1, -1, -1, -1, -1, -1, -1, 
-1, -1, -1, -1, -1, -1, -1, -1, -1, -1, -1, -1, -1, -1, -1, -1, -1, -1, -1, -1, -1, -1, -1, -1, -1, -1, -1, -1, -1, -1, -1, -1, -1, -1, -1, -1, -1, -1, -1, -1, -1, -1, -1, -1, -1, -1, -1, -1, -1, -1, -1, -1, -1, -1, -1, -1, -1, -1, -1, -1, 
-1, -1, -1, -1, -1, -1, -1, -1, -1, -1, -1, -1, -1, -1, -1, -1, -1, -1, -1, -1, -1, -1, -1, -1, -1, -1, -1, -1, -1, -1, -1, -1, -1, -1, -1, -1, -1, -1, -1, -1, -1, -1, -1, -1, -1, -1, -1, -1, -1, -1, -1, -1, -1, -1, -1, -1, -1, -1, -1, -1, 
-1, -1, -1, -1, -1, -1, -1, -1, -1, -1, -1, -1, -1, -1, -1, -1, -1, -1, -1, -1, -1, -1, -1, -1, -1, -1, -1, -1, -1, -1, -1, -1, -1, -1, -1, -1, -1, -1, -1, -1, -1, -1, -1, -1, -1, -1, -1, -1, -1, -1, -1, -1, -1, -1, -1, -1, -1, -1, -1, -1, 
-1, -1, -1, -1, -1, -1, -1, -1, -1, -1, -1, -1, -1, -1, -1, -1, -1, -1, -1, -1, -1, -1, -1, -1, -1, -1, -1, -1, -1, -1, -1, -1, -1, -1, -1, -1, -1, -1, -1, -1, -1, -1, -1, -1, -1, -1, -1, -1, -1, -1, -1, -1, -1, -1, -1, -1, -1, -1, -1, -1, 
-1, -1, -1, -1, -1, -1, -1, -1, -1, -1, -1, -1, -1, -1, -1, -1, -1, -1, -1, -1, -1, -1, -1, -1, -1, -1, -1, -1, -1, -1, -1, -1, -1, -1, -1, -1, -1, -1, -1, -1, -1, -1, -1, -1, -1, -1, -1, -1, -1, -1, -1, -1, -1, -1, -1, -1, -1, -1, -1, -1, 
-1, -1, -1, -1, -1, -1, -1, -1, -1, -1, -1, -1, -1, -1, -1, -1, -1, -1, -1, -1, -1, -1, -1, -1, -1, -1, -1, -1, -1, -1, -1, -1, -1, -1, -1, -1, -1, -1, -1, -1, -1, -1, -1, -1, -1, -1, -1, -1, -1, -1, -1, -1, -1, -1, -1, -1, -1, -1, -1, -1, 
-1, -1, -1, -1, -1, -1, -1, -1, -1, -1, -1, -1, -1, -1, -1, -1, -1, -1, -1, -1, -1, -1, -1, -1, -1, -1, -1, -1, -1, -1, -1, -1, -1, -1, -1, -1, -1, -1, -1, -1, -1, -1, -1, -1, -1, -1, -1, -1, -1, -1, -1, -1, -1, -1, -1, -1, -1, -1, -1, -1, 
-1, -1, -1, -1, -1, -1, -1, -1, -1, -1, -1, -1, -1, -1, -1, -1, -1, -1, -1, -1, -1, -1, -1, -1, -1, -1, -1, -1, -1, -1, -1, -1, -1, -1, -1, -1, -1, -1, -1, -1, -1, -1, -1, -1, -1, -1, -1, -1, -1, -1, -1, -1, -1, -1, -1, -1, -1, -1, -1, -1, 
-1, -1, -1, -1, -1, -1, -1, -1, -1, -1, -1, -1, -1, -1, -1, -1, -1, -1, -1, -1, -1, -1, -1, -1, -1, -1, -1, -1, -1, -1, -1, -1, -1, -1, -1, -1, -1, -1, -1, -1, -1, -1, -1, -1, -1, -1, -1, -1, -1, -1, -1, -1, -1, -1, -1, -1, -1, -1, -1, -1, 
-1, -1, -1, -1, -1, -1, -1, -1, -1, -1, -1, -1, -1, -1, -1, -1, -1, -1, -1, -1, -1, -1, -1, -1, -1, -1, -1, -1, -1, -1, -1, -1, -1, -1, -1, -1, -1, -1, -1, -1, -1, -1, -1, -1, -1, -1, -1, -1, -1, -1, -1, -1, -1, -1, -1, -1, -1, -1, -1, -1, 
-1, -1, -1, -1, -1, -1, -1, -1, -1, -1, -1, -1, -1, -1, -1, -1, -1, -1, -1, -1, -1, -1, -1, -1, -1, -1, -1, -1, -1, -1, -1, -1, -1, -1, -1, -1, -1, -1, -1, -1, -1, -1, -1, -1, -1, -1, -1, -1, -1, -1, -1, -1, -1, -1, -1, -1, -1, -1, -1, -1, 
-1, -1, -1, -1, -1, -1, -1, -1, -1, -1, -1, -1, -1, -1, -1, -1, -1, -1, -1, -1, -1, -1, -1, -1, -1, -1, -1, -1, -1, -1, -1, -1, -1, -1, -1, -1, -1, -1, -1, -1, -1, -1, -1, -1, -1, -1, -1, -1, -1, -1, -1, -1, -1, -1, -1, -1, -1, -1, -1, -1, 
-1, -1, -1, -1, -1, -1, -1, -1, -1, -1, -1, -1, -1, -1, -1, -1, -1, -1, -1, -1, -1, -1, -1, -1, -1, -1, -1, -1, -1, -1, -1, -1, -1, -1, -1, -1, -1, -1, -1, -1, -1, -1, -1, -1, -1, -1, -1, -1, -1, -1, -1, -1, -1, -1, -1, -1, -1, -1, -1, -1, 
-1, -1, -1, -1, -1, -1, -1, -1, -1, -1, -1, -1, -1, -1, -1, -1, -1, -1, -1, -1, -1, -1, -1, -1, -1, -1, -1, -1, -1, -1, -1, -1, -1, -1, -1, -1, -1, -1, -1, -1, -1, -1, -1, -1, -1, -1, -1, -1, -1, -1, -1, -1, -1, -1, -1, -1, -1, -1, -1, -1, 
@MapLine  4
   96,  768,      864,  768,    0.00000,-1.00000
   96,  237,       84,  773,    0.99975,0.02238
  871,  767,      859,  239,    -0.99974,0.02272
  874,  243,       94,  247,    0.00513,0.99999
@EvtMap  2
  741,  348,     3,  2,   0
  153,  718,     1,  0,   0
